1111111111111111111111111111111111
1SSSSSSSSSSSSSSSSSSSSSSSSSSSSSSSS1
1SSSSSSSSSSSSSSSSSSSSSSSSSSSSSSSS1
1SSSSSSSSSSSSSSSSSSSSSSSSSSSSSSSS1
1SSSSSSSSSSSSSSSSSSSSSSSSSSSSSSSS1
1SSSSSSSSSSSSSSSSSSSSSSSSSSSSSSSS1
1SSSSSSSSSSSSSSSSSSSSSSSSSSSSSSSS1
1111111111111111111111111111111111
1SSSSSE000000C0000000000000PSSSSS1
1111111111111111111111111111111111
1SSSSSSSSSSSSSSSSSSSSSSSSSSSSSSSS1
1SSSSSSSSSSSSSSSSSSSSSSSSSSSSSSSS1
1SSSSSSSSSSSSSSSSSSSSSSSSSSSSSSSS1
1SSSSSSSSSSSSSSSSSSSSSSSSSSSSSSSS1
1SSSSSSSSSSSSSSSSSSSSSSSSSSSSSSSS1
1SSSSSSSSSSSSSSSSSSSSSSSSSSSSSSSS1
1SSSSSSSSSSSSSSSSSSSSSSSSSSSSSSSS1
1111111111111111111111111111111111