11111111111
1E00C0000P1
11111111111