11111111111111111111
1SSSSSSSSSSSSSSSSSS1
1SCCCCCCCCCCCCCCCCS1
1SCSSSSSSSSCCCCCCCS1
1SCSSSSSSSSCSSSSSSS1
1SCSECCCCSSCSPCCCCS1
1SCSSSSSCSSCSSSSSCS1
1SCCCCCCCSSCCCCCCCS1
1SSSSSSSSSSSSSSSSSS1
11111111111111111111