111111111111
1E10C01000P1
10001000C001
111111111111