11111111111111111
1E0000000000000C1
10000S00100000001
1000000010S000001
1C0000000000000P1
11111111111111111