1111111111111
1000CC1000C01
10S01C0010C01
1000100010C01
10E0100S10P01
1111111111111