111111111111111111111
1C00000000C00000000C1
1000S00000100000S0001
100000000010000000001
100000S0001000S000001
100000000C1C000000001
1C11111111111111111C1
100000000C1C000000001
100000S0001000S000001
100000000010000000001
1000S00000100000S0001
1C0000000PCE0000000C1
111111111111111111111