1111111
100S001
1E000C1
100S001
1111101
100S001
1C000C1
100S001
1011111
100S001
1C000P1
100S001
1111111