1111111111111111111111111
100011111100C001100011111
10P0111110S000S0000011111
1000111110001000100011111
1S00111110C010C01S0011111
1000111110001000100011111
100S000000S000S0100S00E01
100000001100C001100000001
1111111111111111111111111