1111111111111111
1000111SS1110001
10E0011SS110SC01
110P001111000011
1110000110000111
1111000000001111
1SS110CSSC011SS1
1SS110CSSC011SS1
1111000000001111
1110000110000111
1100001111000011
10CS011SS110SC01
1000111SS1110001
1111111111111111