1111111111111111111111111111
1P00000000C00SS00C00000000C1
1011111111011111101111111101
101C0000000SCSSCS0000000C101
1010111S101101101101S1110101
101S001C001000000100C100S101
1010101110001CC1000111010101
1CS01C0000101SS1010000C10SC1
1010101110001CC1000111010101
101S001C001000000100C100S101
1010111S101101101101S1110101
101C0000000SCSSCS0000000C101
1011111111011111101111111101
1C00000000C00SS00C00000000E1
1111111111111111111111111111