1111111111111111111111111111111111
10E0000C00000000000001000000000001
100000000C00C000000001000000000001
100000000C00C000000001000000000001
1P0000000C00C000000001000000000001
100000000C00C000000001000000000001
100000000C00C000000001000000000001
100000000C00C000000001000000000001
100000000C00C000000001000000000001
100000000C00C000000001000000000001
100000000C00C000000001000000000001
100000000C00C000000001000000000001
1111111111111111111111111111111111