1111111111111111111111111111111111
10E0000C0000000000000100000C000001
100000000C00C000000000000S00C00001
100000000C00C0S000000S00000C000001
1P0000000C00C0000000010000S00000C1
1111111111111111111111111111111111