1111111111111111111111111111111111
1E00000C00000000000001000000000001
1P0000000C00C000000001000000C00001
1111111111111111111111111111111111