111111111111111111111111111111111
1E00000C000000000000100000C000001
100000000C00C00000000000100C00001
100000000C00C0100000100000C000001
100000000C00C000000010000100000C1
1P0000000111111CCCCC10000100000C1
111111111111111111111111111111111