1111111111111111111111111111111111
100000000CC0000000CCCCC00000000001
10000000C0C00000000000C00000000001
1000000CCCC0000000CCCCC00000000001
1000000000C0000000C000000000000001
1000000000C0000000CCCCC00000000001
1000000000000000000000000000000001
1111111111111111S01111111111111111
1SSSSSE000000C0000000000000PSSSSS1
1111111111111111110111111111111111
1000000000000000000000000000000001
1000000000000000000000000000000001
1000000000000000000000000000000001
1000000000000000000000000000000001
1000000000000000000000000000000001
10000000000000000CC000000000000001
1000000000000000000000000000000001
1111111111111111111111111111111111